1111111111111111111111111111111111
100001111100000000000000000000001
100001111100000000000000000000001
100001111100000000000000000000001
100001111100000000000000000000001
100001111100000000000000000000001
100001111100000000000000000000001
100001111100000000000000000000001
100001111100000000000000000000001
100001111100000000000000000000001
100001111100000000000000000000001
100001111100000000000000000000001
100001111100000000000000000000001
100001111100000000000000000000001
100001111100000000000000000000001
100001111100000000000000000000001
100001111100000000000000000000001
1PC000E000000000000000000000000C1
111111111111111111111111111111111